11111111111111111111111
1E001000000000001000001
10P01C01111110011000101
11011111CCC100001001101
1000000100010C000C01001
1000CC01101111111111011
10000000000000000000001
11111111111101111111101
10010000C010000000C1001
100001111110CCC01111CC1
10010000000000001000001
11111111111111111111111