111111111
10E100001
1011011P1
100C00111
100C00CC1
111111111